111111111111111111111111111111111111
10C0C0C0C0C0C0C0C0C0C0C0C0C0C0C0C0E1
1C0C0C0C0C0C0C0C0C0C0C0C0C0C0C0C0C01
1C0C0C0C0C0C0C0C0C0C0C0C0C0C0C0C0C01
10C0C0C0C0C0C0C0C0C0C0C0C0C0C0C0C0C1
1C0C0C0C0C0C0C0C0C0C0C0C0C0C0C0C0C01
10C0C0C0C0C0C0C0C0C0C0C0C0C0C0C0C0C1
1P0C0C0C0C0C0C0C0C0C0C0C0C0C0C0C0C01
111111111111111111111111111111111111
