001111111111111111111
1E000000C000000000001
101001010100101010101
101001001110000010101
1P000000C0000000000C1
111111111111111111111
